***********************************************************************************************************************
*.....................................................................................................................*
*.....................................................................................................................*
*.....................................................................................................................*
*.....................................................................................................................*
*.....................................................................................................................*
*.....................................................................................................................*
*.....................................................................................................................*
*.............................***************.....***************.....***************.................................*
*.............................*..........................*...................*........................................*
*.............................*..........................*...................*........................................*
*.............................*..........................*...................*........................................*
*.............................*..........................*...................*........................................*
*.............................************...............*...................*........................................*
*.............................*..........................*...................*........................................*
*.............................*..........................*...................*........................................*
*.............................*..........................*...................*........................................*
*.............................*..........................*...................*........................................*
*.............................*..........................*...................*........................................*
*.............................*...................***************............*........................................*
*.....................................................................................................................*
*...................................................*.*.*.....*.*.*...................................................*
*..................................................*......*.*......*..................................................*
*.................................................*........*........*.................................................*
*..................................................*...............*..................................................*
*....................................................*...........*....................................................*
*......................................................*.......*......................................................*
*........................................................*...*........................................................*
*..........................................................*..........................................................*
***********************************************************************************************************************